1111111111111111111
1P00000010000000001
10C011101110C110001
1100000000000100C01
10011111E11100100C1
100C00000000C010001
10001110111110110C1
1000000000000000001
1001111111011100001
1111111111111111111
