1111111
1PE0C01
1000001
1111111
