111111111111111111111
1P0000001000000C00001
10C011101110111010001
110000000000010000C01
1001111111110E11110C1
100C00000000C01000001
100011101111101110001
100000000000000000C01
10011110111011101C001
100000000000000000001
100111110111011110001
111111111111111111111
