11111111111
1P000100001
100C01E0C01
11000111001
100000000C1
10001110001
11111111111
