11111111111111111
1P000001000000001
100C110111101C001
110000000000110C1
100111111110001C1
100000C0000111001
10011111110001001
10000000E00000001
11111111111111111
