11111111111111111111111
1P000000010000000C00001
10C0111011101110C110001
11000000000000100000C01
100111111111100111100C1
100C000000E00C01000C001
1000111011111011100C001
100000000000000000000C1
100111101110111011110C1
10000000000000000000001
1001111101110110111C001
10000000000000000000001
11111111111111111111111
