1111111111111
1P000010000E1
100C101110001
11000000100C1
10011111100C1
10000000000C1
1000000000001
1111111111111
