111111111111111111111111
1P0000000100000000C00001
10C01110111011101C111001
110000000000001000000C01
100111111111100111110001
100C0000000000C010000C01
10001110111110111001C001
1000000000000000000000C1
1001111011101110111101C1
100000000000000000000C01
100111110111E11101111C01
100000000000000000000C01
111111111111111111111111
