111111111
1P0000E01
10C010C01
100001001
100000001
111111111