111111111111111
1P0000100000001
10C010100C100C1
11000E111010001
100000000011001
10011111C001001
100000000000001
111111111111111
